111111111111111111
1C0000P00000010C01
101100110011C00001
100C100E00010001C1
111111111111111111