11111
11EP1
101C1
1C011
11111
