111111
100001
100p01
100001
111111
