11111111111111
1C0000C0000001
1000C000000001
100000C0000C01
1P000C000C00E1
11111111111111